NO ./textures/north.xpm                 

SO ./textures/south.xpm                 
EA ./textures/east.xpm              


WE 			./textures/west.xpm              

F              220,100,0
C 225,0, 0

11111
10N01

11111
11111