NO ./textures/north.xpm                 

SO ./textures/south.xpm                 
EA ./textures/east.xpm              


WE 			./textures/west.xpm              

F 220,100,0
C 225,0, 0



111111
100001
1000N1
111111